....................
..G.................
..#........#.....#.G
.................#.G
.......#.........#.G
.................#.G
GGGG........GGG..#.G
####.......------#.G
......C..........#.G
......#####......#.G
.................#.X
.........GG...C..###
.....-------------..
.1..........CCG..CC.
####################
