....................
....................
........A.X.C.......
.......######.......
..C...............B.
####..G.G.G.G....###
.......G.G.GCG......
......########......
...##...........##..
.......C............
.A.G............B.G.
----.......C....----
....................
.1.......A....B.....
####################
