GGGGGGGGGGGGGGGGGGGG
GGGGGGGGGGGGGGGGXGGG
GGG--GGGGGGGGGG--GGG
GGGGGG--GGGGGGGGGGGG
GGG--GGGGGGGGGG--GGG
GGGGGGGGGGBGGGGBGGGG
GGG--GGGG--GGGG--GGG
GGGCGGGGGGGGGGGGAGGG
GGG--GGGGGGGGGG--GGG
GGGCGGGGGGGG--GGCGGG
GGG--GGGGGGGGGG--GGG
GGGGGGGGGGGGGGGGCGGG
GGG--GGGGGGGGGG--GGG
G1GGGGGGGGGGGGGGGGGG
####################
